taxon,X2012,X2013,X2014,X2015,X2016,X2017,X2018,X2019,total
Hildenbrandia,79,65,80,69,76,75,81,77,602
Fucus.distichus,64,53,67,57,52,45,63,54,455
Pyropia,47,57,61,47,37,57,53,68,427
Mastocarpus,60,57,59,65,41,39,55,46,422
Petrocelis,40,49,63,52,61,62,27,27,381
Barnacles,53,27,45,35,49,43,63,57,372
Corallina,45,51,47,45,50,45,42,45,370
Endocladia.muricata,47,37,47,44,45,44,46,46,356
Chamberlainium.tumidum,43,42,49,39,39,45,47,43,347
Ulva,48,47,51,53,36,32,39,39,345
Halosaccion.glandiforme,44,40,52,29,28,26,38,47,304
Bossiella_articulate,25,35,29,41,42,42,43,35,292
Alaria.marginata,41,44,35,30,11,23,25,32,241
Acrosiphonia,28,41,41,21,13,30,30,36,240
Anemone,36,9,32,20,31,32,36,41,237
Plocamium.violaceum,24,27,21,29,37,31,25,15,209
Mazzaella.oregona,43,23,32,23,22,30,18,11,202
Microcladia.borealis,17,18,31,27,19,23,24,17,176
Callithamnion.pikeanum,24,22,13,21,25,26,24,19,174
Cryptosiphonia.woodii,20,14,31,21,14,22,28,21,171
Gloiopeltis.furcata,21,26,22,19,26,11,20,19,164
coralline.crust,29,19,13,31,13,16,29,6,156
Leathesia.marina,15,9,32,25,10,20,29,14,154
Hymenena,16,19,17,16,19,16,19,14,136
Phyllospadix.sp.,10,17,14,16,15,18,20,16,126
Polyneura.latissima,15,21,13,14,21,14,12,11,121
Mazzaella.splendens,18,13,16,13,19,11,13,17,120
Neorhodomela.larix,19,11,15,13,15,16,16,14,119
Ptilota,17,17,13,18,14,17,12,6,114
Savoiea.robusta,8,15,13,9,16,19,21,13,114
Mytilus.sp.,13,3,4,8,18,24,24,17,111
Odonthalia.floccosa,18,17,10,11,10,13,13,13,105
Elachista.fucicola,23,33,17,11,2,3,13,1,103
Cladophora.columbiana,9,10,6,11,20,10,15,11,92
Ralfsioid,7,8,4,33,11,7,15,7,92
Lithothamnion.phymatodeum,6,10,9,9,13,14,19,11,91
Polysiphonia,9,13,6,8,6,10,18,21,91
Hedophyllum.sessile,12,8,14,13,10,8,7,9,81
Ceramium.pacificum,5,8,5,9,15,6,16,5,69
Neopolyporolithon.reclinatum,7,12,8,5,7,9,9,9,66
Lithophyllum,0,0,13,6,12,13,10,11,65
Neogastroclonium.subarticulatum,6,11,6,7,10,8,9,6,63
Mazzaella.parvula,2,6,11,16,8,3,10,4,60
Prionitis,9,11,3,4,10,10,7,5,59
Farlowia.mollis,1,16,3,5,10,10,10,3,58
Egregia.menziesii,5,11,8,8,10,6,3,5,56
Dilsea.californica,6,3,7,7,4,11,9,7,54
Palmaria.hecatensis,10,10,7,3,6,2,4,9,51
Codium.fragile,7,6,7,1,4,5,9,4,43
Tube.worms,9,2,0,2,5,3,11,9,41
Nemalion.helminthoides,9,2,2,9,5,2,11,0,40
Analipus.japonicus,5,5,10,5,4,1,7,2,39
Bossiella_crust,0,0,5,0,8,5,4,12,34
Bryozoan,16,6,1,5,1,0,1,4,34
Schizymenia.pacifica,0,1,7,7,4,6,2,7,34
Scytosiphon.lomentaria,2,5,1,1,0,7,14,4,34
Tunicata/Porifera,10,3,3,1,0,5,5,6,33
Codium.setchellii,5,4,3,3,4,3,4,4,30
Hedophyllum.nigripes,4,5,6,3,1,5,3,3,30
Costaria.costata,1,7,8,4,1,4,0,1,26
Ectocarpus.commensalis,0,0,0,6,2,2,7,9,26
Osmundea.spectabilis,2,6,3,3,5,3,4,0,26
Peyssonnelia.sp.,0,0,0,3,5,5,4,7,24
Palmaria.mollis,2,12,2,3,2,0,1,1,23
Blidingia,1,0,6,4,3,2,1,5,22
Scytosiphon.dotyi,1,6,1,3,1,2,5,3,22
Colpomenia.bullosa,0,0,0,2,0,11,4,4,21
Calliarthron.tuberculosum,0,9,0,4,1,2,1,3,20
Tokidadendron.bullatum,3,0,3,2,1,7,3,1,20
Unknown.crust,4,2,0,0,2,4,0,5,17
Salishia.firma,1,4,3,2,4,0,0,0,14
Ahnfeltia.fastigiata,1,5,0,0,3,1,0,2,12
Chiharaea.silvae,0,4,0,0,1,5,0,2,12
Crusticorallina.muricata,0,0,0,0,3,1,0,8,12
Cumathamnion.decipiens,1,4,0,1,0,3,2,1,12
Lomentaria.hakodatensis,2,3,1,1,2,0,0,3,12
Mazzaella.parksii,2,7,1,0,0,0,0,2,12
Melanosiphon.intestinalis,0,4,0,0,0,1,6,1,12
Pollicipes.polymerus,2,0,1,1,0,1,3,4,12
Colpomenia.peregrina,0,0,0,3,0,0,4,4,11
Desmarestia.ligulata,0,0,2,2,3,2,1,1,11
Laminaria.setchellii,0,1,1,2,3,2,0,2,11
Pseudolithophyllum.muricatum,0,0,9,1,0,0,0,0,10
Antithamnionella.pacifica,2,2,3,0,0,2,0,0,9
Chiharaea.rhododactyla,0,0,4,1,0,4,0,0,9
Colonial.Diatoms,0,0,0,2,3,2,0,2,9
Melobesia.sp.,0,0,0,2,4,1,0,2,9
Smithora.naiadum,0,2,0,0,0,4,2,1,9
Antithamnion.defectum,1,2,0,1,2,2,0,0,8
Erythrotrichia.carnea,0,0,0,2,0,4,1,0,7
Johansenia.macmillanii,0,0,0,1,1,3,1,1,7
Nereocystis.luetkeana,0,0,0,1,2,1,2,1,7
Pylaiella.littoralis,0,5,1,0,0,0,1,0,7
Collinsiella.tuberculata,0,0,0,0,0,0,1,5,6
Hydroid,3,1,0,0,0,0,1,1,6
Neorhodomela.oregona,3,0,0,2,0,1,0,0,6
Rhodochorton.purpureum,2,1,3,0,0,0,0,0,6
Bangia.sp.,1,0,0,1,0,0,3,0,5
Cladophora.sericea,1,3,1,0,0,0,0,0,5
Laminaria.yezoensis,1,0,1,2,0,1,0,0,5
Rhizoclonium.tortuosum,1,2,1,0,0,0,1,0,5
Desmarestia.aculeata,1,3,0,0,0,0,0,0,4
Herposiphonia.plumula,0,0,2,0,1,0,0,1,4
Lithothamnion.glaciale,0,0,0,0,0,0,4,0,4
Opuntiella.californica,0,4,0,0,0,0,0,0,4
Pleonosporium.vancouverianum,0,3,0,0,1,0,0,0,4
Soranthera.ulvoidea,1,2,1,0,0,0,0,0,4
Sphacelaria.rigidula,0,2,0,1,0,0,1,0,4
Callophyllis.sp.,0,0,0,0,1,2,0,0,3
Chaetomorpha.cannabina,0,0,0,0,2,0,1,0,3
Flustralidra,1,0,0,0,0,0,0,2,3
Halichondria,2,0,0,0,1,0,0,0,3
Jingle,0,0,0,0,0,0,0,3,3
Monostroma.grevillei,0,3,0,0,0,0,0,0,3
Neorhodomela.aculeata,0,0,1,0,0,2,0,0,3
Odonthalia.floccosa.f..comosa,0,0,0,0,0,1,1,1,3
Plocamium.pacificum,0,0,1,1,0,0,1,0,3
Pterocladiella.caloglossoides,0,0,1,0,1,0,1,0,3
Styela.sp.,0,1,0,2,0,0,0,0,3
Acrochaetium.sp.,0,1,0,1,0,0,0,0,2
Ceramium.codicola,2,0,0,0,0,0,0,0,2
Ectocarpus.sp.,0,0,2,0,0,0,0,0,2
Mesophyllum.vancouveriense,0,0,0,0,0,1,1,0,2
Pterygophora.californica,0,0,0,0,1,1,0,0,2
Symphyocladiella.dendroidea,0,0,0,0,2,0,0,0,2
articulated.coralline,0,0,0,0,0,0,0,1,1
Chiharaea.bodegensis,0,0,0,1,0,0,0,0,1
Dactylosiphon.bullosus,0,0,0,0,0,0,0,1,1
Desmarestia.herbacea,0,0,0,0,0,0,0,1,1
Ectocarpus.siliculosus,0,0,0,0,0,0,1,0,1
Fauchea.sp.,0,0,0,0,1,0,0,0,1
Haliclona,1,0,0,0,0,0,0,0,1
Kornmannia.leptoderma,0,1,0,0,0,0,0,0,1
Petalonia.fascia,0,0,0,0,0,0,0,1,1
Phycodrys.sp.,0,0,0,0,0,1,0,0,1
Pododesmus.sp.,0,0,0,0,1,0,0,0,1
Pugetia.firma,1,0,0,0,0,0,0,0,1
Rhodymenia.sp.,0,0,0,1,0,0,0,0,1
Riterella.pulchra,0,0,0,1,0,0,0,0,1
Tiffaniella.snyderae,0,0,0,0,1,0,0,0,1
Ulothrix-Urospora.sp.,0,1,0,0,0,0,0,0,1
Unknown.red.blade,0,0,0,0,0,0,0,1,1
